###########
#.........#
#.#.#.#.#.#
#.........#
#..#.#.#..#
#.........#
#...###...#
#.........#
#.........#
###########