###########
#.........#
#.#.......#
#.#.......#
#.###@###.#
#.......#.#
#.......#.#
#.......#.#
#.........#
###########