###########
#.........#
#.#.#.#.#.#
#.@.....@.#
#..#.#.#..#
#.........#
#...#.#...#
#....@....#
#....#....#
###########