###########
#.........#
#..@...@..#
#.........#
#..@...@..#
#.........#
##.@...@.##
###.....###
####...####
###########