###########
#.........#
###...#...#
#.........#
#...##..#.#
#....#....#
#....#....#
#....#....#
#....#....#
###########