###########
#.........#
#.#.......#
#.#.......#
#.###.###.#
#.......#.#
#.......#.#
#.......#.#
#.........#
###########