###########
#.........#
#.#..#..#.#
#.........#
#..#...#..#
#.#.....#.#
#...###...#
#....#....#
#.........#
###########